{
    "objects": [
        {
            "x": 10,
            "y": 50,
            "w": 50,
            "h": 200
        },
        {
            "x": 2000,
            "y": 50,
            "w": 50,
            "h": 200
        }
    ]
}